{
    "backgrounds": "cave.png",
    "music": "like_cave.ogg",
    "terrain": [                                                                                                                        
                "                                                                                                                        ",
                "                                                                                                                        ",
                "                                                                                                                        ",
                "                                                                                                                        ",
                "                                                                                                                        ",
                "                                                                                                                        ",
                "                                                                                                                        ",
                "                                                                                                                        ",
                "                                                                                                                        ",
                "                                                                                                                        ",
                "                                                                                                                        ",
                "                                                                                                                        ",
                "                                                                                                                        ",
                "                                                                                                                        ",
                "                                                                                                                        ",
                "          P      P                                                                                  P      P     P      ",
                "                                                                                                                        ",
                "EEEEEEEEEEEEEEEEEEEE\                                                                            /EEEEEEEEEEEEEEEEEEEEEE",
                "EEEEEEEEEEEEEEEEEEEEE\                                                                          /EEEEEEEEEEEEEEEEEEEEEEE",
                "SSSSSSSSSSSSSSSSSSSEEEEEEEE\ P      P                                                       /EEEEEEESSSSSSSSSSSSSSSSSSSS",
                "SSSSSSSSSSSSSSSSSSSSEEEEEEEE\                                                              /EEEEEEEESSSSSSSSSSSSSSSSSSSS",
                "SSSSSSSSSSSSSSSSSSSSSSSSSSSEEEEEEEEEE\                                       P    P    EEEEEESSSSSSSSSSSSSSSSSSSSSSSSSSS",
                "SSSSSSSSSSSSSSSSSSSSSSSSSSSSSSSEEEEEEE\                                               /EEEEEESSSSSSSSSSSSSSSSSSSSSSSSSSS",
                "SSSSSSSSSSSSSSSSSSSSSSSSSSSSSSSSSSSEEEEEEEEEEEE\                          /EEEEEEEEEEEEESSSSSSSSSSSSSSSSSSSSSSSSSSSSSSSS",
                "SSSSSSSSSSSSSSSSSSSSSSSSSSSSSSSSSSSSEEEEEEEEEEEE\                        /EEEEEEEEEEEESSSSSSSSSSSSSSSSSSSSSSSSSSSSSSSSSS",
                "SSSSSSSSSSSSSSSSSSSSSSSSSSSSSSSSSSSSSSSSSSSSSSSEE\WWWWWWWWWWWWWWWWWWWWWW/EESSSSSSSSSSSSSSSSSSSSSSSSSSSSSSSSSSSSSSSSSSSSS",
                "SSSSSSSSSSSSSSSSSSSSSSSSSSSSSSSSSSSSSSSSSSSSSSSSEE\WWWWWWWWWWWWWWWWWWWW/EESSSSSSSSSSSSSSSSSSSSSSSSSSSSSSSSSSSSSSSSSSSSSS",
                "WWWWWWWWWWWWWWWWWWWWWWWWWWWWWWWWWWWWWWWWWWWWWWWWWWWWWWWWWWWWWWWWWWWWWWWWWWWWWWWWWWWWWWWWWWWWWWWWWWWWWWWWWWWWWWWWWWWWWWWW",
                "WWWWWWWWWWWWWWWWWWWWWWWWWWWWWWWWWWWWWWWWWWWWWWWWWWWWWWWWWWWWWWWWWWWWWWWWWWWWWWWWWWWWWWWWWWWWWWWWWWWWWWWWWWWWWWWWWWWWWWWW"
  ]
}