                                                                                                    
                                                    P                                               
                                                   ___                                              
                                                  |III\                                             
         P                                        |IIII\_                                           
      _____________  P                                III|                                          
     /IIIIIIIIIIIIII\_                                                                              
     |IIIIIIIIIIIIIIII\                                           P  ____________                   
     |IIIIIIIIIIIIIIIII\___________                                 /IIIIIIIIIIII|                  
      \IIIIIIIIIIIIIIIIIIIIIIIIIIII|__   P                         /IIIIIIIIII|P  P                 
       \IIIIIIIIIIIIIIIIIIIIIIIIIIIIIII\______                P   /IIIIIIIIIII|________             
       |IIIIIIIIIIIIIIIIIIIIIIIIIIIIIIIIIIIIII\__________   _____/IIIIIIIIIIIIIIIIIIIII|            
       |IIIIIIIIIIII|                        IIIIIIIIIIII\ /IIIIIIIIIIIIIIIIII                      
WWWWWWW|IIIIIIIIIIII|WWWWWWWWWWWWWWWWWWWWWWWWWWWWWWWWWWWWWWWWWWWWWWWWWWWWWWWWWWWWWWWWWWWWWWWWWWWWWWW
WWWWWWWWWWWWWWWWWWWWWWWWWWWWWWWWWWWWWWWWWWWWWWWWWWWWWWWWWWWWWWWWWWWWWWWWWWWWWWWWWWWWWWWWWWWWWWWWWWWW
