{
    "background": "cave.png",
    "music": "like_cave.ogg"
    "terrain":
[
"SSSSSSSSSSSSSSSSSSSSSSSSSSSSSSSSSSSSSSSSSSSSSSSSSSSSSSSSSSSSSSSSSSSSSSSSSSSSSSSSSSSSSSSSSSSSSSSSSSSSSSSSSSSSSSSSSSSSSSSSSSSSSSSSSSSSSSSSSSSSSSSSSSSSSSSSSSSSSSSSSSSSSSSSSSSSSSSSSSSSSSSSSSSSSSSSSSSSSSSSSSSSSSSSSSSSSSSSSSSSSSSSSSSSS",
"SSSSSSSSSSSSSSSSSSSSSSSSSSSSSSSSSSSSSSSSSSSSSSSSSSSSSSSSSSSSSSSSSSSSSSSSSSSSSSSSSSSSSSSSSSSSSSSSSSSSSSSS/        P   \SSSSSSSSSSSSSSSSSSSSSSSSSSSSSSSSSSSSSSSSSSSSSSSSSSSSSSSSSSSSSSSSSSSSSSSSSSSSSSSSSSSSSSSSSSSSSSSSSSSSSSSSSSSSSSS",
"SSSSSSSSSS                    P          \SSSSSSSSSSSSSSSSSSSSSSSSSSSSSSSSSSSSS  P    \SSSSSSSSSSS/                    \SSSSSSSSSSSSSSSSSSSSSSSSSSSSSSSSSSSSSSSSSSSSSSSS/       \SSSSSSSSSSSSSSSSSSSSSSSSSSS/          \SSSSSSSSSSSSS",
"SSSSSSSSSSSSSSSSSSSSSSS\		       \SSSSSSSSSSSSSSSSSSSSSSSSSSSSSSSS        \SSSSSSSS/       /SSSSSSSSSSS\	          \SSSSSSSSSSSSSSSSSSSSSSSSSSSSSS/             P      \SSSSSSSSSSSSSSSSSSS/     P         \SSSSSSSSSSS",
"SSSSSSSSSSSSSSSSSSSSSSSSSSSSSSSSSSSSSSSSSSSSS\         \SSSSSSSSSSSSSSSSSSSSSSSSSSS\      SSSS\       SSSSSSSSSSSSSSSSS\           \SSSSSSSSSSSSSSSSSSSSSSSSSS/        /SSSSS\          \SSSSSSSSSSSS/                           SSSS",
"SSSSSSSSSSSS/  P      SSSSSSSSSSSSSSSSSSSSSSSSSS         SSSSSSSSSSSSSSSSSSSSSSSSSSSS    /SSSSSSS\      \SSSSSSSSSSSSSSSSSSSSS\	 \SSSSSSSSS/               SSSSSSSSSSSSSSSSSS\     \SSSSSSSS/       /SSSSSSSS           /SSSSS",
"SSSSSSSSS/         /SSSSSSSSSSSSSS/      \SSSSS/       /SSSSSSSSSSSSSSSSSSS/            SSSSSSSSSS\      \SSSSSSSSSSSSSSSSSSSSSS\        \SSSSSSS/      /SSSSSSSSSSSSSSSSSSSSSSSSSSSS\     \SSSSS/       /SSSSSSSSSSSSSS/     /SSSSSS",
"SSSSSSS/      /SSSSSSSSSSSSSSSS/       P             /SSSSSSSSSSSSSSSSSS/                \SSSSSSSSSSSSS\    \SSSSSSSSSSSSSSSSSSSSSSS\      \SSSSS/     /SSSSSSSSSSSSSSSSSSSSSSSSSSSSSSS\               /SSSSSSSSSSSSSS/      /SSSSSSS",
"SSS          /SSSSSSSSSSSSSSSS/                    /SSSSSSSSSSSSSSSS/          /SSSSS\     \SSSSSSSSSSSS      SSSSSSSSS/  \SSSSSSSSSS\      \S/      /SSSSSSSSSSSSSSSSSSSSSSSSSSSSSSSSSS\           /SSSSSSSSSSSSSS/      /SSSSSSSSSS",
"SS         SSSSSSSSSSSSSSSSSS/      /SSSSSSSSSSSSSSSSSSSSSSSSSS/          /SSSSSSSSSSSS\    \SSSSSSSSS/   /SSSSSSSSSS/     \SSSSSSSSSS\             /SSSSSSSSS/     \SSSSSSSSSSSSSSSSSSSSS\      /SSSSSSSSSSSSSS/      /SSSSSSSSSSSSS",
"SSSS\       \SSSSSSSSSSSSS/        /SSSSSSSSSSSSSSSSSSSSSSSSS/          /SSSSSSSSSSSSSSSS\               /SSSSSSS/      P     \SSSSSSSSS\   P     /SSSSSSSSS/     P   \SSSSSSSSSSSSSSSSSSSSSSSSSSSSSSSSSSSSSSS/       /SSSSSSSSSSSSSS",
"SSSSSS\        \SSSSSSSS/        /SSSSSSSSSSSSSSSSSSSSSSSS/      P   /SSSSSSSSSSSSSSSSSSSSS\     P      /SSSSS/                   \SSSSSSS\    /SSSSSSSSSS/               \SSSSSSSSSSSSSSSSSSSSSSSSSSSSSSSS/        /SSSSSSSSSSSS    ",
"SSSSSSS\        \SSSSSS/        /SSSSSSSSSSSSSSSSSSSSSSS/          /SSSSSSSSSSSSSSSSSSSSSSSSS\        /SSSSSS/        /SSSSS\         \SSSSSSSSSSSSSSSS/       /SSSSS\        \SSSSSSSSSSSSSSSSSSSSSSSSSS/         /SSSSSSSSSSSS/  P ", 
"SSSSSSSSS\                   SSSSSSSSSSSSSSSSSSSSSSSS/          /SSSSSSSSSSSSS/  \SSSSSSSSSSSSSSSSSSSSSSSSS/     P   /SSSSSSSS\          \SSSSSSSSSSSS/       /SSSSSSS\           \SSSSSSSSSSSSSSSSSSS/           /SSSSSSSSSS/       ",
"SSSSSSSSSSSSS\                                                 /SSSSSSSSSSSS/        \SSSSSSSSSSSSSSSSSSS/          /SSSSSSSSSSS            \SSSSSS/        /SSSSSSSSSSSSSSS\            \SSSSSSS/              /SSSSSSSSSS/       /S",
"SSSSSSSSSSSSSSSSS\                                        /SSSSSSSSSSSSS/               \SSSSSSSSSSSSS/        /SSSSSSSSSSSSSS/       P       \SSS/     P  /SSSSSSSSSSSSSSSSSS\             \SSS/              /SSSSSSSSS/       /SSS",
"SSSSSSSSSSSSSSSSSSSSSSSSSSSSSSSSSSSS   P   SSSSSSSSSSSSSSSSSSSSSSSSSSSS/    P  /SS\       \SSSSSSSSS/        /SSSSSSSSSSSSSS/                             /SSSSSSSSSSSSSSSSSSSSSSS\          \S/               SSSSSSSSS       /SSSSS",   
"SSSSSSSS/  P    \SSSSSSSSSSSSSSS/                 \SSSSSSSSSSSSSSSSSSS/       /SSSSSS\       \SSSSS/         /SSSSSSSSSSSSS/         /SSSSSSSSSSSSSSSSSSSSSSSSSSSSSSSSSSSSSSSSSSSSSS\               /SSS\       \SSSSSS/      /SSSSSS",
"SSSSSSS/         \SSSSSSSSSS/       /SSSSS\        \SSSSSSSSSSSSSS/       /SSSSSSSSSSS        SSS        /SSSSSSSSSSSSSS/         /SSSSSSSSSSSSSSSSSSSSSSSSSSSSSSSSSSSSSSSSSSSSSSSSSS\           /SSSSSSS\    P             /SSSSSSSS",
"SSSSS/    /SSS\    \SSSSSS/       /SSSSSSSSS\        \SSSSSSSSSS/      /SSSSSSSSS/     P               /SSSSSSSSSSSS/        P   SSSSSSSSSSSSSSSSSS/  P   \SSSSSSSSSSSSSSSSSSSSSSSSSSSSS\      SSSSSSSSSSSS\               /SSSSSSSSS",
"SSS/     /SSSSS\              /SSSSSSSSSSSSSS\       \SSSSSS/     /SSSSSSSSSS                         /SSSSSSSSS/      /SSS\       SSSSSSSSSSSSS/                 P                          \SSSSSSSSSSSSSSSSSSSS\      /SSSSSSSSSSS",  
"S/    /SSSSSSSSS\          /SSSSSSSSSSSSSSSSSSSSSS\               /SSSSSSSSSSSSSSSSSSSSSSSSSSSSSSSSSSSSSSSSSSS/       /SSSSSSSSSSSSSSSSSSSSSSSS/     /SSSS\                                          SSSSSSSSSSSSSSSSSSSSSSSSSSSSSSSS",
"    /SSSSSSSSSSSSSSSSSSSSSSSSSSSSSSSSSSSSSSSSSSSSSSS\          /SSSSSSSSSSSSSSSSSSSSSSSS/      P      SSSSSSS      /SSSSSSSSSSSSSSSSSSSSSSSSS/      /SSSSSSSSSSSSSSSSSSSSSSSSSSSSSSSSSS\    P        SSSSSSSSSSSSSSSSSSSSSSS        S",
"    SSSSSSSSSSSSSSSSSSSSSSSSSSSSSSSSSSSSSSSSSSSSSSSSSSSSS\     SSSSSSSSSSSSSSSSSSSS/              /SSSSSSSS      /SSSSSSSSSSSSSSSSSSSSSSSSS/       /SSSSSSSSSSSSSSSSSSSSSSSSSSSSSSSSSSSSS\          SSSSSSSSSSSSSSSSSSSSSSSS       /S",
"SS\  \SSSSSSSSSSSSSSSSSSS/     P          \SSSSSSSSSSSSSSS\    \SSSSSSSSSSSSSSSSS/       /SSSSSSSSSSSSS/       /SSSSSSSSSSSSSSSSSSSSSSSS/      /SSSSSSSSSSSSSSSSSSSSSS               SSSSSSSSSSSSSSSSSSSSSSSSSSSSSSSSSSSSS/       /SS",
"SSS\   \SSSSSSSSSSSSSSS/                          P             \SSSSSSSSSSSS/         /SSSSSSSSSSSSS/       /SSSSSSSSSSSSSSSSSSSSSSSSS/    /SSSSSSSSSSSSSSSSSSSSSSSSSSSSS\        SSSSSSSSSSSSSSSSSSSSSSSSSSSSSSSSSSSSS/        /SSS",
"SSSS\    \SSSSSSSSSS/       /SSSSSSS\                              SSSSSSSS/        /SSSSSSSSSSSSSS/        /SSSSSSSSSSSSSSSSSSSSSSSSS/   /SSSSSSSSSSSSSSSSSS           SSSS\        \SSSSSSSSSSSSSSSSSSSSSSSSSSSSSS/           /SSSS",
"SSSSSS\             P     /SSSSSSSSSSSSSSSSSSSSSSSSSSSSSSSSSSSSSSSSSSS             /SSSSSSSSSSSSSS/        /SSSSSSSSSSSSS/      \SSSS/   SSSSSSSSSSSSSSSSSSSSS\      SSSSSSSSSSS        \SSSSSSSSSSSSSSSSSSSSSSS/    P         SSSSSS",    
"SSSSSSSS\    P         /SSSSSSSSSSSSSSSSSSS              \SSSSSSSS              /SSSSSSSSSSSSSSSS/        SSSSSSSSSSSS           \SS/        \SSSSSSSSSSSSSSSSSS       \SSSSSS/            \SSSSSSSSSSSSSSSS/                  \SSSSS",
"SSSSSSSSSSS\       SSSSSSSSSSSSSSSSSSSSSSSSSS\               \SSSSSS\       SSSSSSSSSSSSSSSSSSSS/          \SSSSSSSSSSSS\         P                                       \SS/               \SSSSSSSSSS/           /SSSS\       \SSS",
"SSSSSSSSSSSSSS\                                P               \SSSSSSSS\     \SSSSSSSSSSSSSS       P           \SSSSSSSSSSSSS\                                                                SSSSSSS/          /SSSSSSSSS\       \S",
"SSSSSSSSSSSSSSSSS\                                               SSSSSSSSSS\      SSSSSSSSSSSSSSSS\                 SSSSSSSSSSSSSSS\            /SSSSSSSSSSSSSSSSSSSSSSSSSSSSSSSSSSSSSSSSSSSSSSSSSSS      P     SSSSSSSSSSSSSSSS\    ", 
"         \SSSSSSSSSS\        /SSSSSSSSSSSSSSSSSSSSSSSSSSS\                     /SSSSSSSSSSSSSSSSSSSSSSSS\       SSSSSSSSSSSSSSSSSSSSSSSS\      SSSSSSSSSSSSSSSSSSSSSSSSSS/     P      \SSSSSSSSSSSSSSSS\             \SSSSSSSSSSSSSSS",     
"      P     \SSSSSSSSSSSSSSSSSSSSSSS         P    \SSSSSSSSSSSSSSSSSSSSS\    /SSSSSSSSSSSSSSSSSSSSSSSSSSSS\        P      \SSSSSSSSSSSSSSS\      \SSSSSSSSSSSSSSSSSSS/                      \SSSSSSSSSSSSSSS\            \SSSSSSSSSSS",
"SSSS\           \SSSSSSSSSSSSSSSSSSSSSSSSSS\         \SSSSSSSSSSSSSSSSSSSSSSSSSSSSSSSSSSSSSSSSSSSSSSSSSSSSSSSS                  \SSSSSSSSSSS\       SSSSSSSSSSSS           /SSSSSS\           \SSSSSSSSSSSSSSSS\            \SSSSSSSS",
"SSSSSSSS\           \SSSSSSSSSSSSSSSSSSSSSSSSS\            \SSSSSSSSSSSSSSSSSSSSSSSSSSSSSSSSSSSSSSSSSSSSS/        /SSSSS\                         SSSSSSSSSSSSSSSSSSS\   /SSSSSSSSS\                         SSSSSS\            \SSSS", 
"SSSSSSSSSSS\                  \SSSSSSSSSSSSSSSSSSS\      P                 \SSSSSSSSSSSSSSSSSSSSSSS/             /SSSSSSSSS\                             \SSSSSSSSSSSSSSSSSSSSSSSSSSSSSSS\                  SSSSSSSSSSS\      P    \S",
"SSSSSSSSSSSSSS\                       \SS/                                            \SSSSSSSSSS/            /SSSSSSSSSSSSSSSSS\                                      \SSSSSSSSSSSSSSSSSSSSSS\           P      \SSSSS\             ",
"SSSSSSSSSSSSSSSSS\         P                            /SSS\               P                    P       /SSSSSSSSSSSSSSSSSSSSSSSSS\       /SSSSSSSS\               P                                                        /SSSSSSS",
"SSSSSSSSSSSSSSSSSSS\                                 /SSSSSSSSS\                                       /SSSSSSSSSSSSSSSSSSSSSSSSSSSSS\   /SSSSSSSSSSSSSS\                                               /SSSSS\             /SSSSSSSS",
"SSSSSSSSSSSSSSSSSSSSSSSSSSSSSSSSSSSSSSSSSSSSSSSSSSSSSSSSSSSSSSSSSSSSSSSSSSSSSSSSSSSSSSSSSSSSSSSSSSSSSSSSSSSSSSSSSSSSSSSSSSSSSSSSSSSSSSSSSSSSSSSSSSSSSSSSSSSSSSSSSSSSSSSSSSSSSSSSSSSSSSSSSSSSSSSSSSSSSSSSSSSSSSSSSSSSSSSSSSSSSSSSSSSSS",
"SSSSSSSSSSSSSSSSSSSSSSSSSSSSSSSSSSSSSSSSSSSSSSSSSSSSSSSSSSSSSSSSSSSSSSSSSSSSSSSSSSSSSSSSSSSSSSSSSSSSSSSSSSSSSSSSSSSSSSSSSSSSSSSSSSSSSSSSSSSSSSSSSSSSSSSSSSSSSSSSSSSSSSSSSSSSSSSSSSSSSSSSSSSSSSSSSSSSSSSSSSSSSSSSSSSSSSSSSSSSSSSSSSSSS",
"LLLLLLLLLLLLLLLLLLLLLLLLLLLLLLLLLLLLLLLLLLLLLLLLLLLLLLLLLLLLLLLLLLLLLLLLLLLLLLLLLLLLLLLLLLLLLLLLLLLLLLLLLLLLLLLLLLLLLLLLLLLLLLLLLLLLLLLLLLLLLLLLLLLLLLLLLLLLLLLLLLLLLLLLLLLLLLLLLLLLLLLLLLLLLLLLLLLLLLLLLLLLLLLLLLLLLLLLLLLLLLLLLLLLL",
"LLLLLLLLLLLLLLLLLLLLLLLLLLLLLLLLLLLLLLLLLLLLLLLLLLLLLLLLLLLLLLLLLLLLLLLLLLLLLLLLLLLLLLLLLLLLLLLLLLLLLLLLLLLLLLLLLLLLLLLLLLLLLLLLLLLLLLLLLLLLLLLLLLLLLLLLLLLLLLLLLLLLLLLLLLLLLLLLLLLLLLLLLLLLLLLLLLLLLLLLLLLLLLLLLLLLLLLLLLLLLLLLLLLLL",
"LLLLLLLLLLLLLLLLLLLLLLLLLLLLLLLLLLLLLLLLLLLLLLLLLLLLLLLLLLLLLLLLLLLLLLLLLLLLLLLLLLLLLLLLLLLLLLLLLLLLLLLLLLLLLLLLLLLLLLLLLLLLLLLLLLLLLLLLLLLLLLLLLLLLLLLLLLLLLLLLLLLLLLLLLLLLLLLLLLLLLLLLLLLLLLLLLLLLLLLLLLLLLLLLLLLLLLLLLLLLLLLLLLLLL",
"LLLLLLLLLLLLLLLLLLLLLLLLLLLLLLLLLLLLLLLLLLLLLLLLLLLLLLLLLLLLLLLLLLLLLLLLLLLLLLLLLLLLLLLLLLLLLLLLLLLLLLLLLLLLLLLLLLLLLLLLLLLLLLLLLLLLLLLLLLLLLLLLLLLLLLLLLLLLLLLLLLLLLLLLLLLLLLLLLLLLLLLLLLLLLLLLLLLLLLLLLLLLLLLLLLLLLLLLLLLLLLLLLLLLL",
]
}
