SSSSSSSSSSSSSSSSSSSSSSSSSSSSSSSSSSSSSSSSSSSSSSSSSSSSSSSSSSSSSSSSSSSSSSSSSSSSSSSSSSSSSSSSSSSSSSSSSSSSSSSSSSSSSSSSSSSSSSSSSSSSSSSSSSSSSSSSSSSSSSSSSSSSSSSSSSSSSSSSSSSSSSSSSSSSSSSSSSSSSSSSSSSSSSSSSSSSSSSSSSSSSSSSSSSSSSSSSSSSSSSSSSSSS
SSSSSSSSSSSSSSSSSSSSSSSSSSSSSSSSSSSSSSSSSSSSSSSSSSSSSSSSSSSSSSSSSSSSSSSSSSSSSSSSSSSSSSSSSSSSSSSSSSSSSSSSSSSSSSSSSSSSSSSSSSSSSSSSSSSSSSSSSSSSSSSSSSSSSSSSSSSSSSSSSSSSSSSSSSSSSSSSSSSSSSSSSSSSSSSSSSSSSSSSSSSSSSSSSSSSSSSSSSSSSSSSSSSSS
SSSSSSSSSS                               \SSSSSSSSSSSSSSSSSSSSSSSSSSSSSSSSSSSSSSSSSSSSSSSSSSSSSSSS/              P     \SSSSSSSSSSSSSSSSSSSSSSSSSSSSSSSSSSSSSSSSSSSSSSSS/       \SSSSSSSSSSSSSSSSSSSSSSSSSSS/          \SSSSSSSSSSSSS
SSSSSSSSSSSSSSSSSSSSSSS\		P      \SSSSSSSSSSSSSSSSSSSSSSSSSSSSSSSS  P     \SSSSSSSS/       /SSSSSSSSSSS\	       \SSSSSSSSSSSSSSSSSSSSSSSSSSSSSSSSS/		 \SSSSSSSSSSSSSSSSSSSSS/      /SSSSS\    \SSSSSSSSSSS
SSSSSSSSSSSSSSSSSSSSSSSSSSSSSSSSSSSSSS  SSSSS\         \SSSSSSSSSSSSSSSSSSSSSSSSSSS\      SSSS\       SSSSSSSSSSSSSSSSS\         \SSSSSSSSSSSSSSSSSSSSSSSSSSSSS        /SSSSS\P      \SSSSSSSSSSSSSS/      P/SSSSSSSSS\          SSSS
SSSSSSSSSSSS/          SSSSSSSSSSSSS/ SSSSSSSSSS         SSSSSSSSSSSSSSSSSSSSSSSSSSSS    /SSSSSSS\      \SSSSSSSSSSSSSSSSSSSSS\	        \SSSSSSSSSS\       SSSSSSSSSSSSSSSSSSSSSSSS\    \SSSSSSSSSS/     /SSSSSSSSSSSSSSSS    /SSSSSS
SSSSSSSSS/       P /SSSSSSSSSSSSSS/      \SSSSS/       /SSSSSSSSSSSSSSSSSSS/            SSSSSSSSSS\      \SSSSSSSSSSSSSSSSSSSSSS\        \SSSSSSSSSS    /SSSSSSSSSSSSSSSSSSSSSSSSSSSS\    \SSSSSSS/     /SSSSSSSSSSSSSS/     /SSSSSSS
SSSSSSS/      /SSSSSSSSSSSSSS             \SSS/      /SSSSSSSSSSSSSSSSSS/       /SSS\   \SSSSSSSSSSSSS\    \SSSSSSSSSSSSSSSSSSSSSSS\      \SSSSSSSS/  /SSSSSSSSSSSSSSSSSSSSSSSSSSSSSSS\     \SSS/     /SSSSSSSSSSSSSS/      /SSSSSSSS
SSS          /SSSSSSSSSSSSSSSSSS       P           /SSSSSSSSSSSSSSSS/          /SSSSS\     \SSSSSSSSSSSS      SSSSSSSSS/  \SSSSSSSSSS\      \SSSS/   /SSSSSSSSSSSSSSSSSSSSSSSSSSSSSSSSSS\           /SSSSSSSSSSSSSS/      /SSSSSSSSSS
SSS         SSSSSSSSSSSSSSSSSS/      /SSSSSSSSSSSSSSSSSSSSSSSSSS/          /SSSSSSSSSSSS\    \SSSSSSSSS/   /SSSSSSSSSS/     \SSSSSSSSSS\           /SSSSSSSSSSS/     \SSSSSSSSSSSSSSSSSSSSS\      /SSSSSSSSSSSSSS/      /SSSSSSSSSSSS
SSSSS\       \SSSSSSSSSSSSS/        /SSSSSSSSSSSSSSSSSSSSSSSSS/          /SSSSSSSSSSSSSSSS\     \SSSS/    /SSSSSSS/            \SSSSSSSSS\       /SSSSSSSSSSS/         \SSSSSSSSSSSSSSSSSSSSSSSSSSSSSSSSSSSSSSS/       /SSSSSSSSSSSSS
SSSSSSS\        \SSSSSSSS/        /SSSSSSSSSSSSSSSSSSSSSSSS/          /SSSSSSSSSSSSSSSSSSSSS\            /SSSSS/         P         \SSSSSSS\ P  /SSSSSSSSSS/       P       \SSSSSSSSSSSSSSSSSSSSSSSSSSSSSSSS/        /SSSSSSSSSSSS/SSSSSSSS\         \SSSS/        /SSSSSSSSSSSSSSSSSSSSSSSS/         P/SSSSSSSSSSSSSSSSSSSSSSSSS\   P    /SSSSSS/       /SSSSS\         \SSSSSSSSSSSSSSSSSS/     /SSSSS\        \SSSSSSSSSSSSSSSSSSSSSSSSSS/         /SSSSSSSSSSSS/     
SSSSSSSSSS\                   SSSSSSSSSSSSSSSSSSSSSSSS/          /SSSSSSSSSSSSS/  \SSSSSSSSSSSSSSSSSSSSSSSSS/        /SSSSSSSS\          \SSSSSSSSSSSS/       /SSSSSSS\           \SSSSSSSSSSSSSSSSSSS/           /SSSSSSSSSS/     P  
SSSSSSSSSSSSS\                                                 /SSSSSSSSSSSS/        \SSSSSSSSSSSSSSSSSSS/       P  /SSSSSSSSSSS            \SSSSSS/        /SSSSSSSSSSSSSSS\            \SSSSSSS/              /SSSSSSSSSS/      /SS
SSSSSSSSSSSSSSSSSS\       /SSSSSS\                        /SSSSSSSSSSSSS/               \SSSSSSSSSSSSS/        /SSSSSSSSSSSSSS/               \SSS/        /SSSSSSSSSSSSSSSSSS\             \SSS/              /SSSSSSSSS/     /SSSSS
SSSSSSSSSSSSSSSSSSSSSSSSSSSSSSSSSSSSS     SSSSSSSSSSSSSSSSSSSSSSSSSSSSS/       /SS\       \SSSSSSSSS/        /SSSSSSSSSSSSSS/         P                 P /SSSSSSSSSSSSSSSSSSSSSSS\          \S/            SSSSSSSSSSSSS     /SSSSSS   
SSSSSSSSSSSSSSSSSSSSSSSSSSSSSSS/      P          \SSSSSSSSSSSSSSSSSSS/      P/SSSSSS\       \SSSSS/         /SSSSSSSSSSSSS/         /SSSSSSSSSSSSSSSSSSSSSSSSSSSSSSSSSSSSSSSSSSSSSS\               /SSS\    \SSSSSSSSS/     /SSSSSSSS
SSSSSSS/     P   \SSSSSSSSSS/       /SSSSS\        \SSSSSSSSSSSSSS/       /SSSSSSSSSSS        SSS        /SSSSSSSSSSSSSS/         /SSSSSSSSSSSSSSSSSSSSSSSSSSSSSSSSSSSSSSSSSSSSSSSSSS\           /SSSSSSS\    \SSSSSS/    /SSSSSSSSSS
SSSSS/    /SSS\    \SSSSSS/       /SSSSSSSSS\        \SSSSSSSSSS/      /SSSSSSSSS/     P    SSSSSSS    /SSSSSSSSSSSS/          SSSSSSSSSSSSSSSSSSSS/      \SSSSSSSSSSSSSSSSSSSSSSSSSSSSSSS\P   SSSSSSSSSSSS\  P          /SSSSSSSSSSS
SSS/     /SSSSS\     \SS/       /SSSSSSSSSSSSSS\       \SSSSSS/     /SSSSSSSSSS     /SSSS\        P   /SSSSSSSSS/      /SSS\P      SSSSSSSSSSSSS/     P      \SSSSSSSSSSSSSSSSSSSSSSSSSSSSSSS\ \SSSSSSSSSSSSSSSS\      /SSSSSSSSSSSSS
S/    /SSSSSSSSS\          /SSSSSSSSSSSSSSSSSSSSSS\               /SSSSSSSSSSSSSSSSSSSSSSSSSSSSSSSSSSSSSSSSSSS/       /SSSSSSSSSSSSSSSSSSSSSSSS/    /SSSS\        P                        \SS\      SSSSSSSSSSSSSSSSSSSSSSSSSSSSSSSS
    /SSSSSSSSSSSSSSSSSSSSSSSSSSSSSSSSSSSSSSSSSSSSSSS\        /SSSSSSSSSSSSSSSSSSSSSSSSS/      P      SSSSSSS      /SSSSSSSSSSSSSSSSSSSSSSSSS/      /SSSSSSSSSSSSSSSSSSSSSSSSSSSSSSSSSS\     \SSS    SSSSSSSSSSSSSSSSSSSSSSS      SSSS
    SSSSSSSSSSSSSSSSSSSSSSSSSSSSSSSSSSSSSSSSSSSSSSSSSSSSS\   SSSSSSSSSSSSSSSSSSSSSS/        /SSS\ /SSSSSSSSSSS  /SSSSSSSSSSSSSSSSSSSSSSSSS/       /SSSSSSSSSSSSSSSSSSSSSSSSSSSSSSSSSSSSS\  P       SSSSSSSSSSSSSSSSSSSSSSSSS   /SSSSS
SS\  \SSSSSSSSSSSSSSSSSSSSSSSSSSSSSSSSSSSSSSSSSSSSSSSSSSSS\    \SSSSSSSSSSSSSSSSS/       /SSSSSSSSSSSSSSSSS/   /SSSSSSSSSSSSSSSSSSSSSSSS/      /SSSSSSSSSSSSSSSSSSSSSS               SSSSSSSSSSSSSSSSSSSSSSSSSSSSSSSSSSSSS/  /SSSSSSS
SSS\   \SSSSSSSSSSSSSSS/       P           \SSSSSSSSSSSSSSSS    \SSSSSSSSSSSS/         /SSSSSSSSSSSSSSSSS/   /SSSSSSSSSSSSSSSSSSSSSSSSS/    /SSSSSSSSSSSSSSSSSSSSSSSSSSSSS\        SSSSSSSSSSSSSSSSSSSSSSSSSSSSSSSSSSSSS/   /SSSSSSSS
SSSS\    \SSSSSSSSSS/       /SSSSSSS\             P          /SS\  SSSSSSSS/        /SSSSSSSSSSSSSSSS/      /SSSSSSSSSSSSSSSSSSSSSSSSS/   /SSSSSSSSSSSSSSSSSS           SSSS\        \SSSSSSSSSSSSSSSSSSSSSSSSSSSSSS/      /SSSSSSSSS
SSSSSS\                   /SSSSSSSSSSSSSSSSSSSSSSSSSSSSSSSSSSSSSSSSSSS             /SSSSSSSSSSSSSS/        /SSSSSSSSSSSSS/      \SSSS/   SSSSSSSSSSSSSSSSSSSSS\      SSSSSSSSSSS        \SSSSSSSSSSSSSSSSSSSSSSS/         SSSSSSSSSSS     
SSSSSSSS\           P  /SSSSSSSSSSSSSSSSSSS              \SSSSSSSS              /SSSSSSSSSSSSSSSS/        SSSSSSSSSSSS           \SS/        \SSSSSSSSSSSSSSSSSS       \SSSSSS/            \SSSSSSSSSSSSSSSS/        P         \SSSSS
SSSSSSSSSSS\ P     SSSSSSSSSSSSSSSSSSSSSSSSSS\     P         \SSSSSS\       SSSSSSSSSSSSSSSSSSSS/          \SSSSSSSSSSSS\                        \SSSSSSSSSSS/            \SS/               \SSSSSSSSSS/           /SSSS\       \SSS
SSSSSSSSSSSSSS\       \SSSSSSSSSSSSSSSSSSSSSSSSSSSSSS          \SSSSSSSS\     \SSSSSSSSSSSSSS                   \SSSSSSSSSSSSS\   P                                                               SSSS/          /SSSSSSSSS\       \S
SSSSSSSSSSSSSSSSS\                             P                 SSSSSSSSSS\      SSSSSSSSSSSSSSSS\ P               SSSSSSSSSSSSSSS\            /SSSSSSSSSSSSSSSSSSSSSSSSSSSSSSSSSSSSSSSSSSSSSSSSSSS            SSSSSSSSSSSSSSSS\
       \SSSSSSSSSSSS\        /SSSSSSSSSSSSSSSSSSSSSSSSSSS\                     /SSSSSSSSSSSSSSSSSSSSSSSS\       SSSSSSSSSSSSSSSSSSSSSSSS\      SSSSSSSSSSSSSSSSSSSSSSSSSS/            \SSSSSSSSSSSSSSSS\  P          \SSSSSSSSSSSSSSS     
            \SSSSSSSSSSSSSSSSSSSSSSS              \SSSSSSSSSSSSSSSSSSSSS\    /SSSSSSSSSSSSSSSSSSSSSSSSSSSS\               \SSSSSSSSSSSSSSS\      \SSSSSSSSSSSSSSSSSSS/         P            \SSSSSSSSSSSSSSS\            \SSSSSSSSSSS
SSSS\ P         \SSSSSSSSSSSSSSSSSSSSSSSSSS\ P       \SSSSSSSSSSSSSSSSSSSSSSSSSSSSSSSSSSSSSSSSSSSSSSSSSSSSSSSS     P            \SSSSSSSSSSS\       SSSSSSSSSSSS           /SSSSSS\           \SSSSSSSSSSSSSSSS\            \SSSSSSSS
SSSSSSSS\           \SSSSSSSSSSSSSSSSSSSSSSSSS\            \SSSSSSSSSSSSSSSSSSSSSSSSSSSSSSSSSSSSSSSSSSSSS/        /SSSSS\                         SSSSSSSSSSSSSSSSSSS\   /SSSSSSSSS\                         SSSSSS\            \SSSS   
SSSSSSSSSSS\                  \SSSSSSSSSSSSSSSSSSS\                        \SSSSSSSSSSSSSSSSSSSSSSS/             /SSSSSSSSS\                             \SSSSSSSSSSSSSSSSSSSSSSSSSSSSSSS\                SSSSSSSSSSSSS\           \S
SSSSSSSSSSSSSS\                       \SS/       \SS\    P                            \SSSSSSSSSS/            /SSSSSSSSSSSSSSSSS\                                      \SSSSSSSSSSSSSSSSSSSSSS\              \SSSSSSSSSSS\    P      
SSSSSSSSSSSSSSSSS\                     \/               /SSS\                               \SS/         /SSSSSSSSSSSSSSSSSSSSSSSSS\       /SSSSSSSS\                                      \SSSSSSS       P                  /SSSSSSS
SSSSSSSSSSSSSSSSSSS\       P                         /SSSSSSSSS\            P                    P     /SSSSSSSSSSSSSSSSSSSSSSSSSSSSS\   /SSSSSSSSSSSSSS\           P                                   /SSSSS\             /SSSSSSSS
SSSSSSSSSSSSSSSSSSSSSSSSSSSSSSSSSSSSSSSSSSSSSSSSSSSSSSSSSSSSSSSSSSSSSSSSSSSSSSSSSSSSSSSSSSSSSSSSSSSSSSSSSSSSSSSSSSSSSSSSSSSSSSSSSSSSSSSSSSSSSSSSSSSSSSSSSSSSSSSSSSSSSSSSSSSSSSSSSSSSSSSSSSSSSSSSSSSSSSSSSSSSSSSSSSSSSSSSSSSSSSSSSSSSS
SSSSSSSSSSSSSSSSSSSSSSSSSSSSSSSSSSSSSSSSSSSSSSSSSSSSSSSSSSSSSSSSSSSSSSSSSSSSSSSSSSSSSSSSSSSSSSSSSSSSSSSSSSSSSSSSSSSSSSSSSSSSSSSSSSSSSSSSSSSSSSSSSSSSSSSSSSSSSSSSSSSSSSSSSSSSSSSSSSSSSSSSSSSSSSSSSSSSSSSSSSSSSSSSSSSSSSSSSSSSSSSSSSSSS
LLLLLLLLLLLLLLLLLLLLLLLLLLLLLLLLLLLLLLLLLLLLLLLLLLLLLLLLLLLLLLLLLLLLLLLLLLLLLLLLLLLLLLLLLLLLLLLLLLLLLLLLLLLLLLLLLLLLLLLLLLLLLLLLLLLLLLLLLLLLLLLLLLLLLLLLLLLLLLLLLLLLLLLLLLLLLLLLLLLLLLLLLLLLLLLLLLLLLLLLLLLLLLLLLLLLLLLLLLLLLLLLLLLLL
LLLLLLLLLLLLLLLLLLLLLLLLLLLLLLLLLLLLLLLLLLLLLLLLLLLLLLLLLLLLLLLLLLLLLLLLLLLLLLLLLLLLLLLLLLLLLLLLLLLLLLLLLLLLLLLLLLLLLLLLLLLLLLLLLLLLLLLLLLLLLLLLLLLLLLLLLLLLLLLLLLLLLLLLLLLLLLLLLLLLLLLLLLLLLLLLLLLLLLLLLLLLLLLLLLLLLLLLLLLLLLLLLLLLL
LLLLLLLLLLLLLLLLLLLLLLLLLLLLLLLLLLLLLLLLLLLLLLLLLLLLLLLLLLLLLLLLLLLLLLLLLLLLLLLLLLLLLLLLLLLLLLLLLLLLLLLLLLLLLLLLLLLLLLLLLLLLLLLLLLLLLLLLLLLLLLLLLLLLLLLLLLLLLLLLLLLLLLLLLLLLLLLLLLLLLLLLLLLLLLLLLLLLLLLLLLLLLLLLLLLLLLLLLLLLLLLLLLLLL
LLLLLLLLLLLLLLLLLLLLLLLLLLLLLLLLLLLLLLLLLLLLLLLLLLLLLLLLLLLLLLLLLLLLLLLLLLLLLLLLLLLLLLLLLLLLLLLLLLLLLLLLLLLLLLLLLLLLLLLLLLLLLLLLLLLLLLLLLLLLLLLLLLLLLLLLLLLLLLLLLLLLLLLLLLLLLLLLLLLLLLLLLLLLLLLLLLLLLLLLLLLLLLLLLLLLLLLLLLLLLLLLLLLLL

